Jacob	 Torres
Billy	 Curtis
Jody	 Hudson
Elsa	 Waters
Nicole	 Hanson
Kerry	 Ortiz
Stephanie	 Reese
Tyler	 Guzman
Angel	 Wilkins
Clark	 Wise
Virginia	 Pena
Nicolas	 Santos
Myra	 Burns
Esther	 Mccoy
Mindy	 Hunt
Gerald	 Newton
Courtney	 Jordan
Jeffery	 Fuller
Beverly	 Carlson
Trevor	 Walters
Lamar	 Pratt
Michelle	 Gill
Pete	 Hampton
Jane	 Russell
Byron	 Ball
Mona	 Vargas
Jody	 Freeman
Garry	 Lopez
Miranda	 Lawson
Judith	 Moss
Darrel	 Curry
Forrest	 Sullivan
Roland	 Bowman
Angel	 Ford
Marianne	 Swanson
Edna	 Peterson
Dewey	 Buchanan
Sandra	 Smith
Frederick	 Soto
Joel	 Hill
Patti	 Mccarthy
Gina	 Wheeler
Wilma	 Elliott
Iris	 Holmes
Ramona	 Brock
Juana	 Stevenson
Darla	 Boone
Paul	 Coleman
Archie	 Sutton
Ben	 Rice
Felix	 Casey
Kim	 Collier
Tim	 Wade
Erica	 Santiago
Stacey	 Simpson
Jeannette	 Rowe
Boyd	 Mason
Melvin	 Anderson
Megan	 Wagner
Julia	 Cain
Anna	 Moody
Lorraine	 Day
Maggie	 Nichols
Angelina	 Tate
Stacy	 Cole
Rogelio	 Perry
Carla	 Sims
Jamie	 Patterson
Casey	 Hamilton
Kristin	 Crawford
Jake	 Valdez
Johnnie	 Gomez
Levi	 Norris
Geneva	 Barker
Charlene	 Shelton
Ramiro	 Kelley
Andy	 Brady
Steve	 Goodman
Alfred	 Greene
Opal	 Cruz
Shari	 Maldonado
Carlton	 Horton
Emma	 Haynes
Alan	 Cortez
Dominick	 Simmons
Herman	 Lowe
Andre	 Mack
Delia	 Perkins
Diana	 Hicks
Joe	 Ellis
Julius	 Wells
Gladys	 Griffin
Roxanne	 Mathis
Wallace	 Johnston
Jasmine	 Quinn
Kevin	 Bowers
Santos	 Zimmerman
Joanna	 Henry
Loretta	 Hayes
Rex	 Stanley
Stephen	 Roberson
Nellie	 Freeman
Marjorie	 Schultz
Sophie	 Vargas
Delbert	 Bowman
Wilbert	 Mullins
Florence	 Lane
Henrietta	 Holloway
Henry	 Todd
Lester	 Dawson
Roberta	 Alvarez
Roxanne	 Vaughn
Jermaine	 Foster
Susie	 Howard
Fred	 Norris
Corey	 Gregory
Alex	 Wolfe
Elijah	 Briggs
Jonathan	 Pearson
Nelson	 Poole
Leona	 Hughes
Brian	 Dunn
Roosevelt	 Brewer
Rick	 Pratt
Randall	 Warren
Marty	 Parsons
Naomi	 Mccoy
Essie	 Griffin
Johnnie	 Carroll
Damon	 Hammond
Jerald	 Kim
Betsy	 Myers
Courtney	 Farmer
Jeanette	 Rodriguez
Alma	 Houston
Wilma	 Taylor
Gilberto	 Reid
Maggie	 Rodriquez
Sheri	 Campbell
Jill	 Munoz
Armando	 Hernandez
Camille	 Griffith
Sherman	 Morris
Tomas	 Gutierrez
Shawn	 Strickland
Elvira	 Day
Faye	 Murphy
Dixie	 Francis
Geoffrey	 Oliver
Spencer	 Tate
Georgia	 Robertson
Jacob	 Cross
Vincent	 Romero
Olive	 Dixon
Lucy	 Morton
Cheryl	 Bass
Willie	 Hawkins
Neal	 Martinez
Ruth	 Manning
Philip	 Fuller
Boyd	 Ramsey
Howard	 Reese
Sammy	 Rowe
Sue	 Neal
Latoya	 Adams
Doyle	 Jefferson
Myrtle	 Paul
Leslie	 Moreno
Debra	 Hodges
Raymond	 Hunter
Jerry	 Gill
Manuel	 Barber
Danielle	 Brooks
Betty	 Stephens
Lyle	 Green
Malcolm	 Malone
Tonya	 Chambers
Sherri	 Evans
Joan	 Phelps
Lora	 Walton
Clifton	 Hampton
Rose	 Lloyd
Lorene	 Mclaughlin
Veronica	 Mcdonald
Jim	 Harris
Bill	 Robinson
Bryant	 Powell
Rickey	 Baldwin
Yolanda	 Mills
Krista	 Weaver
Martin	 Goodman
Bob	 Greene
Antoinette	 Cook
Alexis	 Martin
Jody	 Knight
Deanna	 Carlson
Luke	 Morales
Geneva	 Morrison
Michelle	 Harrington
Jonathon	 Scott